Melor	Sevastyan
Yvonne	Hughes
David	Newman
Christian	Walker
Samantha	McGrath
Jan	Davidson
Molly	Stewart
Sue	Morgan
Yi	Fen
Jacob	Hudson
Rebecca	Short
Yanis Morimoto
Srinivas	Rao
Tu	An
Sakshi	Bachchan
Cameron	Burgess
Sebastian	Metcalfe
Dana	Fionola
Jin	Jingyi
Dipti	Patil
Carl	Kelly
Arati	Mishra
Stephen	MacDonald
Sam	White
Sarah	Ince
Hari	Kjerstin
Yawen	Yin
Sue	Gray
Oliver	Taylor
Julia	Sanderson
Nyambura	Ousmane
Heather	Roberts
John	Wilkins
Nalini	Anand
Carol	Lee
